1111111
1P00001
1C01101
1000101
1000E0
1111111
