111111
1P00111
1C00001
1C11001
111E111
111111
