111111
1P0001
1C1111

1C1001
111E11
111111
