1111111
1P00001
1C11101
1C10001
1C1C1E1
1111111