111111
1P0001
111101
1C1001
1E1111
111111
