11111
1P001
1C001
1E1C1
111111