1111111111111
1P0000000CC01

1011111111111
1000000000C01
1011111111111
10000000C0E01
1111111111111
