11111111111111111111111
1P011C000000000000000E1
10011110000000010001111
10011000000000010000001
10011001010001111111101
10000001C1000000C1C0001
11111111111111111111111
